.................
.................
.................
.................
.................
.................
..1------------2.
..|...0000.....|.
..|..00..00..*.|.
..|..0..*.0....|.
..|.1--??--2...|.
..|.|......|...|.
..|.|......|...|.
..|*3------4...|.
..|........@...|.
..|....00000...|.
..|...00.......|.
..|...0........|.
..|..0...*.....|.
..3------------4.
.................
.................
.................
.................
.................
