............||............
.1--2.1---2.||.1---2.1--2.
.|..|.|...|.||.|...|.|..|.
.4--3.4---3.43.4---3.4--3.
..........................
.1--2.12.1------2.12.1--2.
.4--3.||.4--21--3.||.4--3.
......||....||....||......
-----.|4---.||.---3|.-----